--------------------------------
|                        |     |
| --------_-------       |     |
| |              /       |     |
| |--------------|  |  | |     |
|                   |    /     |
- ------------------------------
| |-----------------------------
|                    M         |
|----------------- ----- ----  |
                 |@|   | |  |  |
                 |0|   | |  |  |
                 ---   ---  ----
