--------------------------------
|$  @        !           |     |
| --------_-------       |     |
| | ?            /   !   |     |
| |--------------|  |  | |    !|
|                   |    /     |
- ------------------------------
| |
