--------------------------
|$  @        !           |
| --------_-------       |
| | ?            /       |
| |--------------|  |  | |
|                   |    |
- ------------------------
| |
