--------------------------
|   @                    |
| ----------------       |
| |              |       |
| | |---------   |  |  | |
|                   |    |
--------------------------
