--------------------------------
|$  @        M           |     |
| --------_-------       |     |
| | ?            /   m   |     |
| |--------------|  |  | |    g|
|                   |    /     |
- ------------------------------
| |-----------------------------
|                              |
|----------------- ----- ----  |
                 | |   | |  |  |
                 | |   | |  |  |
                 ---   ---  ----
