--------------------------------
|$  @        M           |     |
| --------_-------       |     |
| | ?            /   m   |     |
| |--------------|  |  | |    g|
|                   |    /     |
- ------------------------------
| |
